11111111111111111111111111111111
10000100000010000000000001010001
10100000101001100110000000000001
11100000001001010000011100110001
10100010001010000000000100001001
11000100011111000010000000001001
10001000100000100010001000010001
10010000010010110000000100000001
10100000000100101001001000001001
10001110001000000100100001000101
10101000000100100110000010000001
10100000000100100000010000001001
10100000100000010001000000011001
11111111111111111111111111111111