111111111111111111111111
100001000001000000010001
101000003001011000000001
122000000100102000001001
101000001000000100001001
110040000010000100001001
100030003000003000100001
104000001001055000000001
105000000100010100001001
100511000300000010000101
101000002001011000000001
101000000001000401001001
101000002000000100001001
111111111111111111111111